XXXXXXXXXXXXXXX
X.X..OX.XOX...X
X.O..OO.O...OOX
X.X.X.X.XOXOXOX
X...O.O....O.OX
XOX.XOX.XOX.XOX
XO.OOO...O.O.OX
X.X.X.XOX.XOX.X
XO.OO.O.OOOOO.X
X.X..OX.XOXOX.X
X..OO.OOOO....X
XXXXXXXXXXXXXXX